@@@@@@@@@@@@@@@@@@@@
@o...@........@...o@
@.@@.@.@@..@@.@.@@.@
@.@.....@..@.....@.@
@.@.@@.@@  @@.@@.@.@
@...... GGGG@.@....@
@.@....@@@@@@.@..@.@
@.@....@   o@.@..@.@
@.@....@ @@@@.@..@.@
@.@...........@..@.@
@.@@.@.@@@@@@.@.@@.@
@o...@...P....@...o@
@@@@@@@@@@@@@@@@@@@@