@@@@@@@@@@@@@@@@@@@@
@....@........@....@
@.@@.@.@@..@@.@.@@.@
@.@.... @..@ ....@.@
@.@.@@.@@..@@.@@.@.@
@.......G.. @.@....@
@.@....@@@@@@.@..@.@
@.@....@    @.@..@.@
@.@....@ @@@@.@..@.@
@.@...........@..@.@
@.@@.@.@@@@@@.@.@@.@
@....@...P....@....@
@@@@@@@@@@@@@@@@@@@@
