@@@@@@@@@@@@@@@@@@@@
@....@........@....@
@.@@.@.@@..@@.@.@@.@
@.@.....@..@.....@.@
@.@.@@.@@..@@.@@.@.@
@.......G...@.@....@
@.@....@@@@@@.@..@.@
@.@....@....@.@..@.@
@.@....@.@@@@.@..@.@
@.@...........@..@.@
@.@@.@.@@@@@@.@.@@.@
@....@...P....@....@
@@@@@@@@@@@@@@@@@@@@
